##############################
#............................#
#..@..########################
#.......................!....#
###.#############............#
#...............(............#
#.......k...............$....#
###>##########################