####################################     #################
#..................................#     #...............#
#..@..########################.....#     #...............#
#.......................!..........#######...............#
###.#############........................................#
#...............(............#.....#######...............#
#.......................$..........#     #...............#
#..#################...............#     #...............#
#..................#...............#     ############....#
#..................#...............#                #....#
#..................#...............#                #....#
#......g...........#########.......##################....#
#........................................................#
###>######################################################
