####################################
#..................................#
#..@..########################.....#
#.......................!..........#
###.#############..................#
#...g...........(............#.....#
#.......................$..........#
#..#################...............#
#..................#...............#
#..................#...............#
#..................#..........g....#
#......g...........#########.......#
#..................................#
###>################################