####################################
#..................................#
#..@..########################.....#
#.......................!..........#
###.#############..................#
#...............(............#.....#
#.......k...............$..........#
#..#################...............#
#..................#...............#
#..................#...............#
#..................#...............#
#..................#########.......#
#..................................#
###>################################