####################################     #################
#..................................#     #...............#
#..@..########################.....#     #........b......#
#.......................!..........#######...............#
###.#############........................................#
#...............(............#.....#######...............#
#.......................$..........#     #...............#
#..#################..........g....#     #...............#
#..................#...............#     ############....#
#..................#...............#                #....#
#..................#...............#                #....#
#......b...........#########.......##################....#
#........................................................#
###>######################################################
