####################################
#..................................#
#..@..########################.....#
#.......................!..........#
###.#############..................#
#...............(............#.....#
#.......................$..........#
#..#################...............#
#..................#...............#
#..................#...............#
#..................#...............#
#......g...........#########.......#
#..................................#
###>################################