####################################     #################
#..................................#     #...............#
#..@..########################.....#     #........b......#
#.....#                      #.....#######...............#
#.....########################...........................#
#...............(..................#######...............#
#.......................$..........#     #...............#
#.............................g....#     #...............#
#..................#########.......#     ############....#
#..................#.......#.......#                #....#
#..................#.......#.......#                #....#
#......b...........#########.......##################....#
#........................................................#
###>######################################################
