####################################
#...@.........#....................#
#.....#########..######............#
#.............#..#.................#
###########.###..#.................#
#................#.................#
##################.................#
#..................................#
#..................#...............#
#..................#...............#
#..................#...............#
#......g...........#...............#
#..................................#
###>################################