#######
#.....#
#..@..#
#.....#
###>###