#############################################
#  _   _                          //\    _  #
# | \ | |                        |/ \|  | | #
# |  \| |   __ _   ____   __ _   _   _  | | #
# | . ` |  / _` | |_  /  / _` | | | | | | | #
# | |\  | | (_| |  / /  | (_| | | |_| | | | #
# |_| \_|  \__,_| /___|  \__, |  \__,_| |_| #
#                        __/ |              #
#                        |___/              #
#############################################