####################################     #################
#..................................#     #...............#
#..@..########################.....#     #........b......#
#.....#                      #.....#######...............#
#.....########################....................!......#
#..................................#######...............#
#.......!........!.....!...........#     #...............#
#.............................g....#     #...............#
#..................#########.......#     ############....#
#.........!........#.......#.......#                #....#
#..................#.......#.......#                #....#
#......b.......!...#########.......##################....#
#........................................................#
###>######################################################
